#########
#.......#
#.......###############
#....*.☻/...........+▾#
#.......#############.#
#########           #*#
                    #.#
                    #õ#
                    #.#
                    #.#
                   ##+###########
                   #▾@.*/.......#
                   ##...#...#.*.#
                    #....*..☻..¬#
                    #▾..#...#...#
                    #▾......*.¬.#
                    #############

