#########
#.......#
#.......###############
#....*..............+.#
#.......#############.#
#########           #*#
                    #.#
                    #.#
                    #.#
                    #.#
                    #+###########
                    #@..........#
                    #...#...#...#
                    #....*.....¬#
                    #...#...#...#
                    #.........¬.#
                    #############

