#########
#.......#
#.......###############
#....*................#
#.......#############.#
#########           #*#
                    #.#
                    #.#
                    #.#
                    #.#
                    #+###########
                    #@..........#
                    #...#...#...#
                    #....*......#
                    #...#...#...#
                    #...........#
                    #############