#########
#.......#
#.......###############
#.....................#
#.......#############.#
#########           #.#
                    #.#
                    #.#
                    #.#
                    #.#
                    #+########
                    #@.......#
                    #........#
                    #........#
                    #........#
                    ##########