#########
#.......#
#.......###############
#....*................#
#.......#############.#
#########           #*#
                    #.#
                    #.#
                    #.#
                    #.#
                    #+########
                    #@*......#
                    #.......¬#
                    #....*...#
                    #......¬.#
                    ##########