#########
#.......#
#.......###############
#....*../...........+.#
#.......#############.#
#########           #*#
                    #.#
                    #õ#
                    #.#
                    #.#
                    #+###########
                    #@.*........#
                    #...#...#.*.#
                    #....*.....¬#
                    #...#...#...#
                    #▾......*.¬.#
                    #############

