#########
#.......#
#.......###############
#....*..............+.#
#.......#############.#
#########           #*#
                    #.#
                    #.#
                    #.#
                    #.#
                    #+###########
                    #@.*........#
                    #...#...#.*.#
                    #....*.....¬#
                    #...#...#...#
                    #.......*.¬.#
                    #############

