#########
#.......#
#.......###############
#....*../...........+▾#
#.......#############.#
#########           #*#
                    #.#
                    #õ#
                    #.#
                    #.#
                    #+###########
                    #@.*/.......#
                    #...#...#.*.#
                    #....*..☻..¬#
                    #...#...#...#
                    #▾......*.¬.#
                    #############

